##############################
####.......#####..#......#####
#............................#
#.......AA...AAA.AA.AA..AAAAA#
##AA##AA#####AA#####A######A.#
#.AA#.AA...AAAAA#A.AA..A..#AA#
#..AAA####...AA####A####AA.A.#
###A####..AA...#......#..AAAA#
#AAAA.....#AA..#A###AAAAA#####
#A###....##A#...AA...........#
#AA..##.........##..####AAA..#
#AAA.....AA#..........####.AA#
#####AAAAA####AAAA.AA##..AAAA#
##############################