##############################
####.......#####..#......####
#............................#
#.......AA...AAA.AA.AA..AAAAA#
##AA##AA#####AA#####A######A.#
#.AA#...........#A.AA..A..#AA#
#..AAA####.....####A####AA.A.#
###A####.......#......#..AAAA#
#.........#....#.###.....#####
#.###....##.#................#
#....##.........##..####.....#
#..........#..........####...#
#####.....####.......##......#
##############################